R 1920 1080

NO ./images/doge.xpm
SO ./images/doge2.xpm
WE ./images/cat.xpm
EA ./images/doge.xpm
S ./images/guard.xpm

C 59,59,59
F 119,113,115

111111111111111
        1111111111111111111111111
        1000000000110000000000001      111
        1011010001110000020000001      101
        10011 1000000000000000001      101
111111111011010001110000000000001      111
100000000011000001110111110111111
11110111111111011100000010001
11110111111111011101010010001
11000000110101011100000010001
11111111110111111111111111011
11111111110111111111111111011
10000220000000001100000010001               11111
1000000000000000110101001N001               10201
11000000110101011111011110001               11111
1111011011110101 101111010001
1111111111111111 111111111111